C 2,40,4
F 10,6,0

EA textures/simonkraft/respawn_anchor_side2.xpm
SO textures/simonkraft/respawn_anchor_side4.xpm
WE textures/simonkraft/respawn_anchor_side3.xpm
NO textures/simonkraft/respawn_anchor_side0.xpm 

11111111111111111111111111111111111111111111111111111111111
11111111111111111111111111111111111100000000000000000000001
10100001000000000100001000010000000000000000000000000000001
10000101111110010100001110110000111100000000000000000000001
1011110100001001010000001110001001 100000000000000000000001
1000010100001100011101100010011001 100000000000000000000001
1011110001000000010001000010110001 100000000000000000000001
1010000101111111110001001000100011 111111111111111111111111
1011100100000000010001011000001001
1010000111111111011011010011101001
1010100000000001001010010010001111
1011111100010001001010110010000001
1000000111110101000010011111110101
1000100100010101011111111000000001
1111100110010101110000000001001001
1N00000000001000001100010010001001
1111111111111111111111111111111111