C 2,40,4
F 10,6,0

EA textures/simonkraft/respawn_anchor_side2.xpm
SO textures/simonkraft/respawn_anchor_side4.xpm
WE textures/simonkraft/respawn_anchor_side3.xpm
NO textures/simonkraft/respawn_anchor_side0.xpm 

1111111111111
11000111000011111
1100011111111111111
10000000100000000001
100000000001111111111
1101111100001
1000010000111111111111111111
1100000011110000000000000001
11100000000000000000N0000101
1111000111110000000000000001
1111111111111111111111111111