C 2,40,4
F 10,6,0

EA textures/simonkraft/respawn_anchor_side2.xpm
SO textures/simonkraft/respawn_anchor_side4.xpm
WE textures/simonkraft/respawn_anchor_side3.xpm
NO textures/simonkraft/respawn_anchor_side0.xpm 


111111111111111
1111000111000011111
111100011111111111111
1110000000100000000001
11000000000001111111111
100101111100001
111000010000111111111111111111
111100000011110000000000000001
1111100000000000000000N0000101
111111000111110000000000000001
111111111111111111111111111111