C 2,40,4
F 10,6,0

EA textures/simonkraft/respawn_anchor_side2.xpm
SO textures/simonkraft/respawn_anchor_side4.xpm
WE textures/simonkraft/respawn_anchor_side3.xpm
NO textures/simonkraft/respawn_anchor_side0.xpm 


111111111111111
1111000111000011111
11110001111111111111111111111111
11100000001000000000011000001
11000000000001111101111001N01
10010111110000100000000010001
111000010000111111111111110001
111100000011110000000000000001
111110000000000000001111000101
111111000111110000000000000001
111111111111111111111111111111