C 2,40,4
F 10,6,0

EA textures/simonkraft/respawn_anchor_side2.xpm
SO textures/simonkraft/respawn_anchor_side4.xpm
WE textures/simonkraft/respawn_anchor_side3.xpm
NO textures/simonkraft/respawn_anchor_side0.xpm 


1111111111111111111111111111111111111111
1000000000001000000000000000000000000001
1001001000001000000000000000000000000001
1001001000001000000000000000000000000001
1111111000001000000000000000000000000001
1001001011111000000000000000000000000001
1001001010000000000000000000011111000001
1001111010000000000000000000010000000001
1000000100000000N00000000000010000000001
1000001010000000011110000000010000000001
1000010100000000001010001111110000000001
1000001000000000001011111000000000000001
1000000001111100000000001000000000000001
1000000001000011111111001000000000000001
1000000001000000000001111100000000000001
1000000001000000011110000011100000000001
1000000001000000000000000000000000000001
1111111111111111111111111111111111111111