F 236,223,204
C 212,235,248

NO texture/wall1.png
WE texture/wall2.png
EA texture/wall3.png
SO texture/wall4.png

1111111111111111111111111111111111
1010000100000000010000100001000001
1000010111111001010000111011000011
1011110100001001010000001110001001
1000010100001100011101100010011001
1011110001000000010001000010110001
1010000101111111110001001000100011
1011100100000000010001011000001001
1010000111111111011011010011101001
1010100000000001001010010010001111
1011111100010001001010110010000001
1000000111110101000010011111110101
1000100100010101011111111000000001
1111100110010101110000000001001001
1E00000000001000001100010010001001
1111111111111111111111111111111111